slip	/slɪp/
obstacle	/ˈɒbstəkəl/
odd	/ɒd/
opportunity	/ˌɒpəˈtjuːnəti/
optional	/ˈɒpʃənəl/
optimistic	/ˌɒptɪˈmɪstɪk/
arbitrary	/ˈɑːbɪtrəri/
architecture	/ˈɑːkɪtektʃə(r)/
absolute	/ˈæbsəluːt/
adequate	/ˈædɪkwət/
advertisement	/ədˈvɜːtɪsmənt/
academic	/ˌækəˈdemɪk/
alcohol	/ˈælkəhɒl/
appetite	/ˈæpɪtaɪt/
acid	/ˈæsɪd/
aspect	/ˈæspekt/
attitude	/ˈætɪtjuːd/
avenue	/ˈævənjuː/
identify	/aɪˈdentɪfaɪ/
idle	/ˈaɪdl/
isolate	/ˈaɪsəleɪt/
outset	/ˈaʊtset/
outstanding	/aʊtˈstændɪŋ/
bother	/ˈbɒðə(r)/
bargain	/ˈbɑːɡən/
bacteria	/bækˈtɪəriə/
barrel	/ˈbærəl/
barrier	/ˈbæriə(r)/
battery	/ˈbætəri/
biology	/baɪˈɒlədʒi/
boundary	/ˈbaʊndri/
burden	/ˈbɜːdn/
burst	/bɜːst/
bureau	/ˈbjʊərəʊ/
blast	/blɑːst/
breadth	/bredθ/
brake	/breɪk/
breed	/briːd/
bundle	/ˈbʌndl/
bunch	/bʌntʃ/
awful	/ˈɔːfl/
auxiliary	/ɔːɡˈzɪliəri/
awkward	/ˈɔːkwəd/
alter	/ˈɔːltə(r)/
orbit	/ˈɔːbɪt/
oral	/ˈɔːrəl/
organ	/ˈɔːɡən/
origin	/ˈɒrɪdʒɪn/
orchestra	/ˈɔːkɪstrə/
automatic	/ˌɔːtəˈmætɪk/
dash	/dæʃ/
dive	/daɪv/
diverse	/daɪˈvɜːs/
the	/ðə/ (before consonants) or /ðiː/ (before vowels)
deaf	/def/
data	/ˈdeɪtə/
decade	/ˈdekeɪd/
decorate	/ˈdekəreɪt/
delicate	/ˈdelɪkət/
domestic	/dəˈmestɪk/
debt	/det/
defect	/ˈdiːfekt/ (noun) or /dɪˈfekt/ (verb)
decent	/ˈdiːsnt/
debate	/dɪˈbeɪt/
decay	/dɪˈkeɪ/
delay	/dɪˈleɪ/
deposit	/dɪˈpɒzɪt/
derive	/dɪˈraɪv/
descend	/dɪˈsend/
discipline	/ˈdɪsəplɪn/
display	/dɪˈspleɪ/
dispose	/dɪˈspəʊz/
disturb	/dɪˈstɜːb/
distinguish	/dɪˈstɪŋɡwɪʃ/
distress	/dɪˈstres/
distribute	/dɪˈstrɪbjuːt/
device	/dɪˈvaɪs/
devise	/dɪˈvaɪz/
deserve	/dɪˈzɜːv/
drift	/drɪft/
drip	/drɪp/
durable	/ˈdjʊərəbl/
duration	/djʊˈreɪʃn/
dumb	/dʌm/
dump	/dʌmp/
dusk	/dʌsk/
jam	/dʒæm/
giant	/ˈdʒaɪənt/
joint	/dʒɔɪnt/
jail	/dʒeɪl/
jealous	/ˈdʒeləs/
generate	/ˈdʒenəreɪt/
genuine	/ˈdʒenjuɪn/
gesture	/ˈdʒestʃə(r)/
germ	/dʒɜːm/
genius	/ˈdʒiːniəs/
geography	/dʒɪˈɒɡrəfi/
geometry	/dʒɪˈɒmətri/
jewel	/ˈdʒuːəl/
junior	/ˈdʒuːniə(r)/
jungle	/ˈdʒʌŋɡl/
abuse	/əˈbjuːs/ (noun) or /əˈbjuːz/ (verb)
oblige	/əˈblaɪdʒ/
abundant	/əˈbʌndənt/
adopt	/əˈdɒpt/
adapt	/əˈdæpt/
adult	/ˈædʌlt/
adjust	/əˈdʒʌst/
offend	/əˈfend/
agency	/ˈeɪdʒənsi/
agent	/ˈeɪdʒənt/
accomplish	/əˈkʌmplɪʃ/
academy	/əˈkædəmi/
echo	/ˈekəʊ/
accelerate	/əkˈseləreɪt/
export	/ˈekspɔːt/ (noun) or /ɪkˈspɔːt/ (verb)
acquire	/əˈkwaɪə(r)/
elbow	/ˈelbəʊ/
emphasize	/ˈemfəsaɪz/
omit	/əˈmɪt/
entry	/ˈentri/
apparent	/əˈpærənt/
appoint	/əˈpɔɪnt/
appeal	/əˈpiːl/
appliance	/əˈplaɪəns/
applicable	/ˈæplɪkəbl/ or /əˈplɪkəbl/
opponent	/əˈpəʊnənt/
approximate	/əˈprɒksɪmət/ (adjective) or /əˈprɒksɪmeɪt/ (verb)
appreciate	/əˈpriːʃieɪt/
appropriate	/əˈprəʊpriət/ (adjective) or /əˈprəʊprieɪt/ (verb)
approach	/əˈprəʊtʃ/
approve	/əˈpruːv/
arise	/əˈraɪz/
arouse	/əˈraʊz/
arithmetic	/əˈrɪθmətɪk/
estimate	/ˈestɪmət/ (noun) or /ˈestɪmeɪt/ (verb)
attach	/əˈtætʃ/
attraction	/əˈtrækʃn/
available	/əˈveɪləbl/
evolution	/ˌiːvəˈluːʃn/
award	/əˈwɔːd/
await	/əˈweɪt/
aware	/əˈweə(r)/
authority	/ɔːˈθɒrəti/
urge	/ɜːdʒ/
urgent	/ˈɜːdʒənt/
earthquake	/ˈɜːθkweɪk/
faculty	/ˈfæklti/
faulty	/ˈfɔːlti/
fate	/feɪt/
fatal	/ˈfeɪtl/
phenomenon	/fəˈnɒmɪnən/
forbid	/fəˈbɪd/
facility	/fəˈsɪləti/
fatigue	/fəˈtiːɡ/
fertilizer	/ˈfɜːtəlaɪzə(r)/
fertile	/ˈfɜːtaɪl/
female	/ˈfiːmeɪl/
flock	/flɒk/
flash	/flæʃ/
flexible	/ˈfleksəbl/
focus	/ˈfəʊkəs/
frown	/fraʊn/
golf	/ɡɒlf/
garbage	/ˈɡɑːbɪdʒ/
gallon	/ˈɡælən/
gallery	/ˈɡæləri/
gap	/ɡæp/
guarantee	/ˌɡærənˈtiː/
gasoline	/ˈɡæsəliːn/
gaze	/ɡeɪz/
guilty	/ˈɡɪlti/
glory	/ˈɡlɔːri/
glorious	/ˈɡlɔːriəs/
glimpse	/ɡlɪmps/
globe	/ɡləʊb/
grand	/ɡrænd/
grant	/ɡrɑːnt/
gratitude	/ˈɡrætɪtjuːd/
grateful	/ˈɡreɪtfl/
hollow	/ˈhɒləʊ/
hardware	/ˈhɑːdweə(r)/
harmony	/ˈhɑːməni/
hostile	/ˈhɒstaɪl/
hydrogen	/ˈhaɪdrədʒən/
household	/ˈhaʊshəʊld/
horror	/ˈhɒrə(r)/
haste	/heɪst/
hatred	/ˈheɪtrɪd/
hence	/hens/
hesitate	/ˈhezɪteɪt/
herd	/hɜːd/
hint	/hɪnt/
holy	/ˈhəʊli/
hook	/hʊk/
humble	/ˈhʌmbl/
evil	/ˈiːvl/
exaggerate	/ɪɡˈzædʒəreɪt/
excess	/ɪkˈses/
exceed	/ɪkˈsiːd/
exceedingly	/ɪkˈsiːdɪŋli/
excursion	/ɪkˈskɜːʃn/
exclaim	/ɪkˈskleɪm/
exclude	/ɪkˈskluːd/
expand	/ɪkˈspænd/
expansion	/ɪkˈspænʃn/
expense	/ɪkˈspens/
expensive	/ɪkˈspensɪv/
explore	/ɪkˈsplɔː(r)/
exploit	/ˈeksplɔɪt/
explosive	/ɪkˈspləʊsɪv/
explode	/ɪkˈspləʊd/
explosion	/ɪkˈspləʊʒn/
extent	/ɪkˈstent/
external	/ɪkˈstɜːnl/
exterior	/ɪkˈstɪəriə(r)/
extraordinary	/ɪkˈstrɔːdnri/
extreme	/ɪkˈstriːm/
equation	/ɪˈkweɪʒn/
equivalent	/ɪˈkwɪvələnt/
elaborate	/ɪˈlæbərət/ (adjective) or /ɪˈlæbəreɪt/ (verb)
elastic	/ɪˈlæstɪk/
electron	/ɪˈlektrɒn/
illegal	/ɪˈliːɡl/
emotional	/ɪˈməʊʃənl/
emotion	/ɪˈməʊʃn/
import	/ˈɪmpɔːt/ (noun) or /ɪmˈpɔːt/ (verb)
impose	/ɪmˈpəʊz/
index	/ˈɪndeks/
individual	/ˌɪndɪˈvɪdʒuəl/
inevitable	/ɪnˈevɪtəbl/
infect	/ɪnˈfekt/
infant	/ˈɪnfənt/
infer	/ɪnˈfɜː(r)/
infinite	/ˈɪnfɪnət/
inferior	/ɪnˈfɪəriə(r)/
inhabitant	/ɪnˈhæbɪtənt/
encounter	/ɪnˈkaʊntə(r)/
enclose	/ɪnˈkləʊz/
incident	/ˈɪnsɪdənt/
insure	/ɪnˈʃʊə(r)/
insurance	/ɪnˈʃʊərəns/
entitle	/ɪnˈtaɪtl/
interfere	/ˌɪntəˈfɪə(r)/
internal	/ɪnˈtɜːnl/
interpret	/ɪnˈtɜːprɪt/
interpretation	/ɪnˌtɜːprɪˈteɪʃn/
environment	/ɪnˈvaɪrənmənt/
invade	/ɪnˈveɪd/
enthusiasm	/ɪnˈθjuːziæzəm/
erect	/ɪˈrekt/
essential	/ɪˈsenʃl/
issue	/ˈɪʃuː/
evolve	/ɪˈvɒlv/
evaluate	/ɪˈvæljueɪt/
yawn	/jɔːn/
yield	/jiːld/
universe	/ˈjuːnɪvɜːs/
universal	/ˌjuːnɪˈvɜːsl/
usage	/ˈjuːsɪdʒ/
utilize	/ˈjuːtəlaɪz/
utility	/juːˈtɪləti/
unique	/juːˈniːk/
column	/ˈkɒləm/
comment	/ˈkɒment/
competition	/ˌkɒmpəˈtɪʃn/
competent	/ˈkɒmpɪtənt/
conservation	/ˌkɒnsəˈveɪʃn/
constant	/ˈkɒnstənt/
conquer	/ˈkɒŋkə(r)/
cargo	/ˈkɑːɡəʊ/
calendar	/ˈkælɪndə(r)/
calculate	/ˈkælkjuleɪt/
campus	/ˈkæmpəs/
candidate	/ˈkændɪdət/
cancel	/ˈkænsl/
capture	/ˈkæptʃə(r)/
catalog	/ˈkætəlɒɡ/
casual	/ˈkæʒuəl/
core	/kɔː(r)/
coarse	/kɔːs/
coil	/kɔɪl/
collision	/kəˈlɪʒn/
commit	/kəˈmɪt/
community	/kəˈmjuːnəti/
comparative	/kəmˈpærətɪv/
compete	/kəmˈpiːt/
consent	/kənˈsent/
conservative	/kənˈsɜːvətɪv/
consistent	/kənˈsɪstənt/
consume	/kənˈsjuːm/
continual	/kənˈtɪnjuəl/
continuous	/kənˈtɪnjuəs/
career	/kəˈrɪə(r)/
cliff	/klɪf/
clue	/kluː/
code	/kəʊd/
cope	/kəʊp/
coach	/kəʊtʃ/
quit	/kwɪt/
quotation	/kwəʊˈteɪʃn/
liable	/ˈlaɪəbl/
launch	/lɔːntʃ/
leather	/ˈleðə(r)/
label	/ˈleɪbl/
laser	/ˈleɪzə(r)/
lest	/lest/
leak	/liːk/
lean	/liːn/
leap	/liːp/
liter	/ˈliːtə(r)/
leisure	/ˈleʒə(r)/
liberal	/ˈlɪbərəl/
liberty	/ˈlɪbəti/
liquor	/ˈlɪkə(r)/
loose	/luːs/
loosen	/ˈluːsn/
luxury	/ˈlʌkʃəri/
modify	/ˈmɒdɪfaɪ/
modest	/ˈmɒdɪst/
molecule	/ˈmɒlɪkjuːl/
marvelous	/ˈmɑːvələs/
magnet	/ˈmæɡnət/
maximum	/ˈmæksɪməm/
manual	/ˈmænjuəl/
manufacture	/ˌmænjuˈfæktʃə(r)/
mild	/maɪld/
moral	/ˈmɒrəl/
moist	/mɔɪst/
moisture	/ˈmɔɪstʃə(r)/
male	/meɪl/
mainland	/ˈmeɪnlænd/
maintain	/meɪnˈteɪn/
marine	/məˈriːn/
mature	/məˈtʃʊə(r)/
merchant	/ˈmɜːtʃənt/
medium	/ˈmiːdiəm/
mixture	/ˈmɪkstʃə(r)/
minimum	/ˈmɪnɪməm/
mere	/mɪə(r)/
missile	/ˈmɪsaɪl/
mission	/ˈmɪʃn/
mist	/mɪst/
mutual	/ˈmjuːtʃuəl/
motive	/ˈməʊtɪv/
motivate	/ˈməʊtɪveɪt/
mood	/muːd/
nonsense	/ˈnɒnsns/
knot	/nɒt/
navigation	/ˌnævɪˈɡeɪʃn/
nylon	/ˈnaɪlɒn/
negative	/ˈneɡətɪv/
naked	/ˈneɪkɪd/
naval	/ˈneɪvl/
necessity	/nəˈsesəti/
network	/ˈnetwɜːk/
nevertheless	/ˌnevəðəˈles/
kneel	/niːl/
neglect	/nɪˈɡlekt/
noticeable	/ˈnəʊtɪsəbl/
nucleus	/ˈnjuːkliəs/
numerous	/ˈnjuːmərəs/
nuisance	/ˈnjuːsns/
neutral	/ˈnjuːtrəl/
poverty	/ˈpɒvəti/
powder	/ˈpaʊdə(r)/
portion	/ˈpɔːʃn/
portable	/ˈpɔːtəbl/
pursue	/pəˈsjuː/
profit	/ˈprɒfɪt/
prominent	/ˈprɒmɪnənt/
prompt	/prɒmpt/
prospect	/ˈprɒspekt/
prosperity	/prɒˈsperəti/
prior	/ˈpraɪə(r)/
private	/ˈpraɪvət/
professional	/prəˈfeʃənl/
prohibit	/prəˈhɪbɪt/
promote	/prəˈməʊt/
provision	/prəˈvɪʒn/
previous	/ˈpriːviəs/
precaution	/prɪˈkɔːʃn/
primitive	/ˈprɪmətɪv/
principal	/ˈprɪnsəpl/
principle	/ˈprɪnsəpl/
prescribe	/prɪˈskraɪb/
prevail	/prɪˈveɪl/
preserve	/prɪˈzɜːv/
rival	/ˈraɪvl/
register	/ˈredʒɪstə(r)/
regulate	/ˈreɡjuleɪt/
radiation	/ˌreɪdiˈeɪʃn/
range	/reɪndʒ/
racial	/ˈreɪʃl/
relevant	/ˈreləvənt/
remedy	/ˈremədi/
render	/ˈrendə(r)/
repetition	/ˌrepəˈtɪʃn/
reputation	/ˌrepjuˈteɪʃn/
rescue	/ˈreskjuː/
region	/ˈriːdʒən/
reinforce	/ˌriːɪnˈfɔːs/
ridiculous	/rɪˈdɪkjələs/
ridge	/rɪdʒ/
reject	/rɪˈdʒekt/
rely	/rɪˈlaɪ/
reliable	/rɪˈlaɪəbl/
relief	/rɪˈliːf/
release	/rɪˈliːs/
religion	/rɪˈlɪdʒən/
religious	/rɪˈlɪdʒəs/
reluctant	/rɪˈlʌktənt/
remarkable	/rɪˈmɑːkəbl/
remote	/rɪˈməʊt/
removal	/rɪˈmuːvl/
respond	/rɪˈspɒnd/
response	/rɪˈspɒns/
restrain	/rɪˈstreɪn/
restraint	/rɪˈstreɪnt/
restrict	/rɪˈstrɪkt/
retain	/rɪˈteɪn/
reveal	/rɪˈviːl/
resolve	/rɪˈzɒlv/
resemble	/rɪˈzembl/
resistant	/rɪˈzɪstənt/
resume	/rɪˈzjuːm/
ruin	/ˈruːɪn/
route	/ruːt/
sorrow	/ˈsɒrəʊ/
shallow	/ˈʃæləʊ/
satellite	/ˈsætəlaɪt/
submerge	/səbˈmɜːdʒ/
submit	/səbˈmɪt/
substantial	/səbˈstænʃl/
subtract	/səbˈtrækt/
sophisticated	/səˈfɪstɪkeɪtɪd/
sake	/seɪk/
shelter	/ˈʃeltə(r)/
semiconductor	/ˌsemikənˈdʌktə(r)/
sensible	/ˈsensəbl/
sensitive	/ˈsensətɪv/
ceremony	/ˈserəməni/
suspicion	/səˈspɪʃn/
survey	/ˈsɜːveɪ/ (noun) or /səˈveɪ/ (verb)
sequence	/ˈsiːkwəns/
shield	/ʃiːld/
shift	/ʃɪft/
signature	/ˈsɪɡnətʃə(r)/
significance	/sɪɡˈnɪfɪkəns/
secure	/sɪˈkjʊə(r)/
security	/sɪˈkjʊərəti/
semester	/sɪˈmestə(r)/
simplify	/ˈsɪmplɪfaɪ/
simplicity	/sɪmˈplɪsəti/
sincere	/sɪnˈsɪə(r)/
shiver	/ˈʃɪvə(r)/
severe	/sɪˈvɪə(r)/
scan	/skæn/
scale	/skeɪl/
sketch	/sketʃ/
skim	/skɪm/
scratch	/skrætʃ/
slide	/slaɪd/
slender	/ˈslendə(r)/
slippery	/ˈslɪpəri/
slope	/sləʊp/
solar	/ˈsəʊlə(r)/
sponsor	/ˈspɒnsə(r)/
spot	/spɒt/
spur	/spɜː(r)/
spill	/spɪl/
spit	/spɪt/
splendid	/ˈsplendɪd/
split	/splɪt/
spray	/spreɪ/
shrink	/ʃrɪŋk/
stable	/ˈsteɪbl/
stale	/steɪl/
stimulate	/ˈstɪmjuleɪt/
strategy	/ˈstrætədʒi/
strike	/straɪk/
stripe	/straɪp/
strength	/streŋθ/
stuff	/stʌf/
suburb	/ˈsʌbɜːb/
subsequent	/ˈsʌbsɪkwənt/
substance	/ˈsʌbstəns/
substitute	/ˈsʌbstɪtjuːt/
subway	/ˈsʌbweɪ/
swallow	/ˈswɒləʊ/
target	/ˈtɑːɡɪt/
talent	/ˈtælənt/
tide	/taɪd/
tidy	/ˈtaɪdi/
title	/ˈtaɪtl/
torture	/ˈtɔːtʃə(r)/
textile	/ˈtekstaɪl/
temporary	/ˈtemprəri/
temple	/ˈtempl/
temptation	/tempˈteɪʃn/
tend	/tend/
tendency	/ˈtendənsi/
tender	/ˈtendə(r)/
tense	/tens/
terror	/ˈterə(r)/
territory	/ˈterətri/
terminal	/ˈtɜːmɪnl/
tedious	/ˈtiːdiəs/
timber	/ˈtɪmbə(r)/
tissue	/ˈtɪʃuː/
tone	/təʊn/
tropical	/ˈtrɒpɪkl/
transform	/trænsˈfɔːm/
transmit	/trænzˈmɪt/
transport	/ˈtrænspɔːt/ (noun) or /trænˈspɔːt/ (verb)
trap	/træp/
triangle	/ˈtraɪæŋɡl/
trial	/ˈtraɪəl/
triumph	/ˈtraɪʌmf/
trace	/treɪs/
tremble	/ˈtrembl/
tremendous	/trəˈmendəs/
trend	/trend/
treaty	/ˈtriːti/
tuition	/tjuˈɪʃn/
twist	/twɪst/voluntary	/ˈvɒləntri/
volume	/ˈvɒljuːm/
volcano	/vɒlˈkeɪnəʊ/
vacuum	/ˈvækjuːm/
valley	/ˈvæli/
valid	/ˈvælɪd/
vanish	/ˈvænɪʃ/
vibrate	/vaɪˈbreɪt/
via	/ˈvaɪə/
violence	/ˈvaɪələns/
violent	/ˈvaɪələnt/
violet	/ˈvaɪələt/
vital	/ˈvaɪtl/
vague	/veɪɡ/
vacant	/ˈveɪkənt/
vain	/veɪn/
vocabulary	/vəˈkæbjələri/
venture	/ˈventʃə(r)/
vary	/ˈveəri/
variable	/ˈveəriəbl/
variation	/ˌveəriˈeɪʃn/
vessel	/ˈvesl/
vertical	/ˈvɜːtɪkl/
virtue	/ˈvɜːtʃuː/
version	/ˈvɜːʃn/
vehicle	/ˈviːəkl/
video	/ˈvɪdiəʊ/
victim	/ˈvɪktɪm/
vivid	/ˈvɪvɪd/
ultimate	/ˈʌltɪmət/
undergo	/ˌʌndəˈɡəʊ/
undergraduate	/ˌʌndəˈɡrædʒuət/
undertake	/ˌʌndəˈteɪk/
onion	/ˈʌnjən/
vote	/vəʊt/
utter	/ˈʌtə(r)/
wander	/ˈwɒndə(r)/
wax	/wæks/
waist	/weɪst/
weld	/weld/
welfare	/ˈwelfeə(r)/
wealthy	/ˈwelθi/
weed	/wiːd/
weave	/wiːv/
withdraw	/wɪðˈdrɔː/
witness	/ˈwɪtnəs/
withstand	/wɪðˈstænd/
wonder	/ˈwʌndə(r)/
zone	/zəʊn/
thrust	/θrʌst/